1 2
7 2
3
1 11 2 6 8 6 9
6 11 2 10 3 10 4
10 11 2 10 3 10 4
0 0 0 0 0 0 0 0 0 0 0 0 0 0 0 0 0
0 0 1 1 1 1 1 1 1 1 1 5 1 1 1 1 0
0 0 0 0 0 0 1 1 0 0 0 0 0 0 1 1 0
0 0 0 0 0 0 1 1 0 0 0 0 0 0 1 1 0
0 0 0 0 0 0 0 0 0 0 0 0 0 0 1 1 0
0 0 0 0 0 0 0 0 0 0 0 0 0 0 1 1 0
0 1 1 1 0 0 1 1 0 0 1 4 1 1 1 1 0
0 1 9 1 0 0 1 1 0 0 0 0 0 0 0 0 0
0 1 1 1 0 0 1 1 0 0 0 0 0 0 0 0 0
0 0 1 1 0 0 1 1 0 0 0 0 0 0 0 0 0
0 0 1 1 1 1 1 1 1 1 1 6 1 1 1 0 0
0 0 0 0 0 0 0 0 0 0 0 0 0 0 0 0 0