3 3
7 3
2
6 12 2 10 13 7 15
8 12 0 4 10 9 10 10 1 4 1 5 0
0 0 0 0 0 0 0 0 0 0 0 0 0 0 0 0 0
0 0 1 1 1 1 1 1 0 0 0 0 0 0 0 0 0
0 0 1 1 0 0 1 1 1 0 0 0 0 0 0 0 0
0 2 2 1 0 0 1 1 1 1 0 0 0 0 0 0 0
0 2 2 0 0 0 0 0 1 1 1 0 0 0 0 0 0 
0 2 2 0 0 0 0 0 0 1 1 1 0 0 0 0 0
0 2 1 1 1 0 0 0 0 0 1 1 5 0 0 0 0
0 0 1 6 1 0 0 0 0 0 0 1 1 1 1 1 0
0 0 1 1 1 1 1 1 0 0 0 1 4 1 1 1 0
0 0 0 1 0 0 1 1 0 0 0 1 1 1 0 0 0
0 0 0 1 0 0 1 1 1 1 1 1 1 1 0 0 0
0 0 0 0 0 0 0 0 0 0 0 0 0 0 0 0 0