7 4
2 12
7
2 6 0 0 2 2 4 2 5 
2 7 0 0 2 2 9 2 10
1 2 2 2 6 2 8
2 1 2 1 2 2 3
2 3 2 2 1 2 3
3 2 2 2 1 3 2
7 10 2 1 2 2 1
0 0 0 0 0 0 0 0 0 0 0 0 0 0 0
0 0 5 0 0 0 0 0 0 0 0 1 1 1 0
0 5 1 5 0 0 3 3 1 0 0 1 6 1 0
0 0 5 0 0 0 0 0 0 0 0 1 1 1 0
0 0 0 0 0 0 0 0 0 0 0 0 0 0 0
0 0 0 0 0 0 0 0 0 0 0 0 0 0 0
0 0 0 1 1 1 0 0 0 1 1 1 0 0 0
0 0 0 1 1 1 1 1 1 1 5 1 0 0 0
0 0 0 1 1 1 0 0 0 1 1 1 0 0 0
0 0 0 0 0 0 0 0 0 0 0 0 0 0 0 
