4 2
2 13
4
3 7 0 2 8 3 4 13 0
4 5 0 2 8 3 4 13 0
10 3 1 4 13 0 0
10 10 1 8 3 0 0
0 0 0 0 0 0 0 0 0 0 0 0 0 0 0 0
0 0 0 0 0 0 1 1 0 0 0 0 1 1 1 0
0 0 0 0 1 1 1 1 1 1 0 0 1 6 1 0
0 1 1 1 1 1 1 4 1 1 1 1 1 1 1 0
0 1 1 1 1 4 0 0 1 1 1 1 1 0 0 0
0 1 1 1 0 0 0 0 0 0 1 1 1 0 0 0
0 0 1 0 0 0 0 0 0 0 0 1 0 0 0 0
0 0 1 0 0 0 0 0 0 0 0 1 0 0 0 0
0 0 1 0 0 0 0 0 0 0 1 1 0 0 0 0
0 0 1 1 0 0 0 0 0 0 1 1 0 0 0 0
0 0 0 3 0 0 0 0 0 0 3 0 0 0 0 0
0 0 0 0 0 0 0 0 0 0 0 0 0 0 0 0