5 3
2 5
3
6 2 0 0 2 4 11 4 12
8 13 1 8 15 0 0
3 15 0 2 4 11 4 12 2 7 10 7 13
0 0 0 0 0 0 0 0 0 0 0 0 0 0 0 0 0
0 0 0 0 1 1 1 1 1 2 2 1 1 1 1 0 0                  
0 0 0 0 1 6 1 1 0 0 0 0 0 2 1 0 0 
0 0 0 0 1 1 1 0 0 0 0 0 0 2 1 3 0  
0 0 0 0 0 0 0 0 2 1 1 1 1 1 1 1 0 
0 0 0 1 0 0 0 0 2 2 0 0 0 0 0 1 0 
0 0 3 1 2 0 0 0 2 2 0 0 0 0 0 1 0 
0 2 2 2 2 0 0 0 1 1 0 0 0 0 1 1 0 
0 2 2 2 1 2 1 2 2 1 2 0 0 3 1 0 0 
0 1 2 2 2 2 2 2 2 2 2 2 2 1 0 0 0 
0 0 2 1 2 2 2 0 0 2 2 2 2 1 0 0 0
0 0 0 0 0 0 0 0 0 0 0 0 0 0 0 0 0 
