4 1
5 14
0
0 0 0 0 0 0 0 0 0 0 0 0 0 0 0 0 0
0 0 0 0 0 0 1 1 1 1 1 1 0 0 0 0 0
0 0 0 0 0 0 1 0 0 1 1 1 0 0 0 0 0
0 0 0 0 0 0 1 0 0 1 1 1 1 1 0 0 0
0 1 1 1 1 1 1 0 0 0 0 0 1 1 1 1 0 
0 0 0 0 0 1 1 1 0 0 0 0 1 1 6 1 0
0 0 0 0 0 1 1 1 0 0 0 0 0 1 1 1 0
0 0 0 0 0 0 0 1 0 0 1 1 0 0 0 0 0
0 0 0 0 0 0 0 1 1 1 1 1 0 0 0 0 0
0 0 0 0 0 0 0 1 1 1 1 1 0 0 0 0 0
0 0 0 0 0 0 0 0 1 1 1 0 0 0 0 0 0
0 0 0 0 0 0 0 0 0 0 0 0 0 0 0 0 0