3 9
9 14
6
3 8 2 2 6 2 7
5 10 2 2 6 2 7
5 8 2 2 14 8 14
7 13 2 7 11 7 12
5 4 2 2 6 2 7
8 2 2 2 11 2 12
0 0 0 0 0 0 0 0 0 0 0 0 0 0 0 0 0
0 0 0 0 0 0 0 0 0 0 0 0 0 1 1 1 0
0 0 0 1 1 1 1 1 1 1 1 0 0 1 1 1 0
0 0 0 1 1 1 0 0 4 1 1 0 0 1 1 1 0
0 0 0 1 1 1 0 0 1 1 1 0 0 0 0 0 0
0 0 0 1 4 1 0 0 7 1 4 0 0 0 0 0 0
0 0 0 1 1 1 0 0 1 1 1 0 0 0 0 0 0
0 1 1 1 1 0 0 0 1 1 1 0 0 5 1 1 0
0 1 5 0 0 0 0 0 0 0 0 0 0 1 1 1 0
0 0 0 0 0 0 0 0 0 0 0 0 0 1 9 1 0
0 0 0 0 0 0 0 0 0 0 0 0 0 1 1 1 0
0 0 0 0 0 0 0 0 0 0 0 0 0 0 0 0 0