2 2
7 2
3
4 14 0 2 10 7 10 10 0
6 14 0 1 10 10 0
6 13 0 1 10 7 0
0 0 0 0 0 0 0 0 0 0 0 0 0 0 0 0 0
0 1 1 1 0 0 0 0 1 1 1 1 1 1 1 1 0
0 1 1 1 1 1 1 1 1 1 1 1 0 0 1 1 0
0 1 1 1 0 0 0 0 1 1 0 0 0 0 1 1 0
0 0 0 0 0 0 0 0 0 0 0 0 0 1 3 1 0
0 0 0 0 0 0 0 0 0 0 0 0 0 1 1 0 0
0 1 1 1 0 0 2 2 2 2 1 0 0 4 4 0 0
0 1 6 1 2 2 2 2 2 2 2 0 0 1 1 1 0
0 1 1 1 2 2 2 2 2 2 2 2 2 1 1 1 0
0 0 0 0 0 0 2 2 2 2 2 2 2 1 1 1 0
0 0 0 0 0 0 0 1 1 1 1 0 0 0 0 0 0
0 0 0 0 0 0 0 0 0 0 0 0 0 0 0 0 0