5 2
5 14
1
5 5 2 2 11 8 11
0 0 0 0 0 0 0 0 0 0 0 0 0 0 0 0 0
0 0 0 0 0 0 0 0 0 0 1 1 1 0 0 0 0
0 0 0 0 0 0 0 0 0 0 1 1 1 0 0 0 0
0 0 0 0 0 0 0 0 0 0 1 1 1 0 0 0 0
0 1 1 1 1 1 1 0 0 0 1 1 1 1 1 1 0
0 1 1 1 1 7 1 0 0 0 1 1 1 1 9 1 0
0 1 1 1 1 1 1 0 0 0 1 1 1 1 1 1 0
0 0 0 0 0 0 0 0 0 0 1 1 1 0 0 0 0
0 0 0 0 0 0 0 0 0 0 1 1 1 0 0 0 0
0 0 0 0 0 0 0 0 0 0 1 1 1 0 0 0 0
0 0 0 0 0 0 0 0 0 0 0 0 0 0 0 0 0