4 3
8 13
6
4 2 0 2 4 9 4 10 0
2 3 0 4 4 13 4 14 9 2 9 3 0
6 3 0 4 4 13 4 14 9 2 9 3 0
1 8 0 0 2 4 9 4 10
7 9 0 0 4 4 13 4 14 9 2 9 3
9 4 1 5 6 0 0
0 0 0 0 0 0 0 0 0 0 0 0 0 0 0 0 0
0 0 0 0 0 0 0 0 4 0 0 0 0 0 0 0 0
0 1 1 4 1 0 0 0 1 0 0 0 0 0 0 0 0
0 1 1 1 1 1 0 0 1 0 0 0 0 0 0 0 0
0 1 4 1 1 1 1 1 1 0 0 1 1 0 0 1 0
0 1 1 1 1 1 0 0 0 1 0 0 0 1 0 0 0
0 1 1 4 1 0 0 0 0 1 0 0 0 1 0 0 0
0 1 0 0 0 0 0 0 0 4 0 0 1 1 1 0 0
0 1 0 0 0 0 0 0 0 0 0 1 1 6 1 0 0
0 1 0 0 3 0 0 0 0 0 0 1 1 1 1 0 0
0 0 0 0 0 0 0 0 0 0 0 0 0 0 0 0 0
