4 2
4 14
1
5 10 0 0 1 7 4
0 0 0 0 0 0 0 0 0 0 0 0 0 0 0 0 0
0 0 0 0 0 0 0 0 0 1 1 1 1 0 0 0 0
0 0 0 0 0 0 0 0 0 1 1 1 1 0 0 0 0
0 1 1 1 0 0 0 0 0 1 0 0 1 1 1 1 0
0 1 1 1 1 1 1 1 1 1 0 0 0 1 6 1 0
0 1 1 1 0 0 0 0 1 1 3 0 0 1 1 1 0
0 1 1 1 0 0 0 0 1 1 1 0 0 1 1 1 0
0 0 1 1 0 0 0 0 1 0 0 0 0 0 0 0 0
0 0 0 1 1 1 1 1 1 0 0 0 0 0 0 0 0
0 0 0 0 0 0 0 0 0 0 0 0 0 0 0 0 0
