5 2
2 14
2
3 3 2 5 5 5 6 0 0
2 9 2 5 11 5 12 0 0
0 0 0 0 0 0 0 0 0 0 0 0 0 0 0 0 0
0 0 0 0 0 0 0 1 1 1 1 0 0 1 1 1 0
0 1 1 1 1 0 0 1 1 3 1 0 0 1 6 1 0
0 1 1 4 1 0 0 1 1 1 1 0 0 1 1 1 0
0 1 1 1 1 0 0 1 1 1 1 0 0 1 1 1 0
0 1 1 1 1 0 0 1 1 1 1 0 0 1 1 1 0
0 1 1 1 1 0 0 1 1 1 1 0 0 0 0 0 0
0 0 0 0 0 0 0 0 0 0 0 0 0 0 0 0 0