4 8
9 2
6
1 3 0 2 7 11 7 12 2 1 11 1 12
1 13 0 0 2 6 6 7 6
7 13 0 0 2 4 2 4 3
10 13 0 6 1 4 1 5 1 11 1 12 7 11 7 12 2 4 13 4 14
4 15 0 0 1 10 4
4 1 0 2 10 11 10 12 2 9 4 9 5
0 0 0 0 0 0 0 0 0 0 0 0 0 0 0 0 0
0 0 0 4 1 1 1 0 0 0 1 0 0 3 0 0 0                  
0 0 0 0 0 0 1 0 0 0 1 0 0 0 0 0 0 
0 0 0 0 0 0 1 1 1 1 1 0 0 0 0 0 0  
0 3 0 0 1 1 1 1 1 1 1 1 1 0 0 3 0 
0 0 0 0 0 0 1 1 1 1 1 0 0 0 0 0 0 
0 0 0 0 0 0 0 1 0 0 1 0 0 0 0 0 0 
0 0 0 0 0 0 0 1 0 0 1 1 1 4 0 0 0 
0 1 1 1 0 0 1 1 0 0 1 0 0 0 0 0 0 
0 1 6 1 0 0 1 0 0 0 1 0 0 0 0 0 0 
0 1 1 1 0 0 0 0 0 0 1 1 1 4 0 0 0
0 0 0 0 0 0 0 0 0 0 0 0 0 0 0 0 0 
