7 11
4 3
3
3 12 2 9 3 9 4 0 0
1 14 4 8 3 8 4 2 5 2 6 0 0
8 6 2 3 5 3 6 0 0
0 0 0 0 0 0 0 0 0 0 0 0 0 0 0 0 
0 0 0 0 0 0 0 0 0 0 0 0 0 1 3 0
0 0 0 1 1 1 1 1 1 0 0 0 1 1 1 0
0 0 1 1 1 0 0 1 1 0 0 1 3 1 1 0
0 0 1 6 1 0 0 0 1 1 1 1 1 0 0 0
0 0 1 1 1 0 0 0 0 1 1 1 0 0 0 0
0 0 0 0 0 0 0 0 0 0 1 1 0 0 0 0
0 0 0 0 0 1 1 1 0 0 1 1 0 0 0 0
0 1 1 0 0 1 3 1 0 0 1 1 0 0 0 0
0 1 1 0 0 1 1 1 1 1 1 1 0 0 0 0
0 0 0 0 0 0 0 0 0 0 0 0 0 0 0 0
