6 11
8 8
3
2 8 0 2 4 3 4 4 0
1 14 2 6 11 4 13
8 2 0 0 2 5 4 8 10
0 0 0 0 0 0 0 0 0 0 0 0 0 0 0 0
0 0 0 0 0 0 1 1 1 1 0 0 0 0 5 0
0 0 0 0 0 0 1 1 4 1 1 1 0 0 1 0
0 0 0 0 0 1 1 1 1 1 1 1 0 0 1 0
0 1 1 1 1 1 1 1 1 0 0 1 1 1 1 0
0 1 1 1 0 0 0 1 0 0 0 1 1 0 0 0
0 1 1 1 0 0 0 1 0 0 0 1 0 0 0 0
0 0 1 0 0 0 0 1 1 1 0 0 0 0 0 0
0 0 3 0 0 0 0 1 6 1 0 0 0 0 0 0
0 0 0 0 0 0 0 1 1 1 0 0 0 0 0 0
0 0 0 0 0 0 0 0 0 0 0 0 0 0 0 0