8 13
2 13
5
8 8 0 8 3 5 3 6 3 10 3 11 8 5 8 6 8 10 8 11 0
5 7 0 8 3 5 3 6 3 10 3 11 8 5 8 6 8 10 8 11 0
9 7 2 8 5 8 6 0 0
2 9 2 3 10 3 11 0 0
9 3 0 2 3 5 3 6 3 1 15 2 15 3 15
0 0 0 0 0 0 0 0 0 0 0 0 0 0 0 0 0
0 0 0 0 0 0 0 0 0 0 0 0 1 1 1 0 0
0 0 1 1 1 0 0 0 0 3 0 0 1 6 1 0 0 
0 0 1 1 1 1 1 1 1 1 0 0 1 1 1 0 0
0 0 1 1 1 0 0 1 1 1 0 0 0 1 0 0 0
0 0 2 2 2 0 0 4 1 1 0 0 0 2 0 0 0
0 0 0 2 0 0 0 1 1 1 0 0 2 2 2 0 0
0 0 0 1 0 0 0 1 1 1 0 0 1 1 1 0 0
0 1 1 1 1 0 0 1 4 1 1 1 1 1 1 0 0
0 1 1 3 1 0 0 3 0 0 0 0 1 1 1 0 0
0 1 1 1 1 0 0 0 0 0 0 0 0 0 0 0 0
0 0 0 0 0 0 0 0 0 0 0 0 0 0 0 0 0