3 5
9 4
2
9 14 2 4 3 4 2 0 0
4 13 2 3 3 3 2 0 0
0 0 0 0 0 0 0 0 0 0 0 0 0 0 0 0
0 0 0 0 0 0 0 0 0 1 1 1 0 0 0 0
0 0 0 0 1 1 1 0 0 1 1 1 0 0 0 0
0 1 0 0 1 1 1 1 1 1 1 1 1 1 1 0
0 1 0 0 1 1 1 0 0 0 0 0 0 3 1 0
0 1 0 0 0 0 0 0 0 0 0 0 0 1 1 0
0 1 0 0 0 0 0 0 0 0 0 0 0 1 1 0
0 1 1 1 1 1 0 0 0 1 1 1 1 1 1 0
0 0 1 1 6 1 0 0 0 1 1 1 0 0 0 0
0 0 0 1 1 1 0 0 0 1 1 1 1 1 3 0
0 0 0 0 0 0 0 0 0 0 0 0 0 0 0 0	 