7 3
5 5
2
1 13 1 5 7
3 7 1 3 13

0 0 0 0 0 0 0 0 0 0 0 0 0 0 0
0 0 0 0 0 0 0 0 0 0 0 0 0 3 0
0 0 0 0 0 0 1 1 1 0 0 1 1 1 0
0 0 0 0 0 0 1 3 1 1 1 1 1 0 0
0 0 0 0 1 1 1 1 1 0 0 1 1 0 0
0 0 0 0 1 9 1 0 0 0 0 1 1 0 0
0 0 1 1 1 1 1 0 0 0 1 1 1 1 0
0 1 1 1 1 0 0 0 0 0 1 1 1 1 0
0 1 1 1 1 0 0 1 1 1 1 1 0 0 0
0 0 0 0 0 0 1 1 1 0 0 0 0 0 0
0 0 0 0 0 0 1 1 1 0 0 0 0 0 0
0 0 0 0 0 0 0 0 0 0 0 0 0 0 0
