3 2
7 12
5
2 12 0 0 2 3 3 3 4
2 14 2 7 6 7 8
3 6 0 0 1 8 8
4 1 0 0 1 2 4
8 6 0 0 2 7 9 7 10
0 0 0 0 0 0 0 0 0 0 0 0 0 0 0 0
0 0 0 0 0 0 0 0 0 0 0 1 1 1 1 0
0 0 0 0 0 1 1 1 1 1 1 1 3 1 5 0
0 0 1 0 0 1 3 1 0 0 0 1 1 1 1 0
0 3 1 0 0 1 1 0 0 0 0 0 0 1 0 0
0 1 1 0 0 1 0 0 0 0 0 0 0 1 0 0
0 1 1 1 1 1 0 0 0 0 0 1 1 1 0 0
0 1 1 1 0 0 1 1 1 0 0 1 6 1 0 0
0 0 0 0 0 0 3 1 0 0 0 1 1 1 0 0
0 0 0 0 0 0 0 0 0 0 0 0 0 0 0 0