6 1
2 3
1
7 7 2 1 5 1 6
0 0 0 0 0 0 0 0 0 0 0 0 0 0
0 0 1 1 1 1 0 0 0 0 0 0 0 0
0 0 1 9 1 1 0 0 0 0 0 0 0 0
0 0 1 1 1 0 0 0 0 0 0 0 0 0
0 0 1 0 0 0 1 1 1 1 1 1 0 0
0 0 1 0 0 0 1 1 0 0 1 1 0 0
0 1 1 1 1 1 1 1 0 0 1 1 1 0
0 0 0 0 0 0 1 4 0 0 0 0 1 0
0 0 0 0 0 0 1 1 1 1 0 0 1 0
0 0 0 0 0 0 1 1 1 1 1 1 1 0
0 0 0 0 0 0 0 0 0 1 1 1 0 0
0 0 0 0 0 0 0 0 0 0 0 0 0 0