8 2
4 12
3
7 3 0 0 2 5 9 5 10
9 9 3 7 4 7 5 4 8 0 0
3 5 4 5 9 5 10 3 14 4 14 0 0
0 0 0 0 0 0 0 0 0 0 0 0 0 0 0 0
0 0 0 1 1 0 0 0 0 0 0 0 0 0 0 0
0 0 0 1 1 1 0 0 0 0 0 0 0 0 0 0
0 0 0 1 1 4 0 0 0 0 0 1 1 1 0 0
0 0 0 0 1 1 1 1 0 0 0 1 6 1 0 0
0 0 0 0 0 0 0 1 1 0 0 1 1 1 0 0
0 0 1 1 0 0 0 1 1 0 0 0 0 0 0 0
0 1 1 3 1 1 1 1 1 0 0 0 0 0 0 0
0 1 1 1 0 0 0 1 1 0 0 0 1 1 1 0
0 1 1 1 0 0 0 1 1 4 1 1 1 1 1 0
0 0 0 0 0 0 0 0 0 0 0 0 1 1 1 0