9 2
9 13
5
8 12 0 2 9 12 0
10 12 2 9 12
6 8 2 9 2 2 14
4 9 4 2 6 2 7 2 11 2 12 0 0
2 12 4 2 6 2 7 3 3 3 4 0 0
0 0 0 0 0 0 0 0 0 0 0 0 0 0 0 0 0
0 0 0 0 0 0 0 0 1 1 1 0 0 1 1 1 0
0 0 0 0 0 1 1 1 1 1 1 0 0 3 1 1 0
0 1 1 0 0 1 0 0 1 1 1 0 0 1 1 1 0
0 1 1 1 1 1 0 0 0 4 0 0 0 0 0 0 0
0 1 1 0 0 0 0 0 0 0 0 0 0 0 0 0 0
0 0 1 0 0 0 0 0 5 0 0 0 0 0 0 0 0
0 0 1 0 0 0 0 0 1 0 0 0 0 0 0 0 0
0 1 1 1 0 0 0 1 1 1 0 0 4 1 1 0 0
0 1 1 1 1 1 1 1 1 1 1 1 1 6 1 0 0
0 1 1 1 0 0 0 1 1 1 0 0 4 1 1 0 0
0 0 0 0 0 0 0 0 0 0 0 0 0 0 0 0 0
