8 2
4 12
3
7 3 2 5 9 5 10
9 9 3 7 4 7 5 4 8
3 5 4 5 9 5 10 3 14 4 14
0 0 0 0 0 0 0 0 0 0 0 0 0 0 0 0
0 0 0 1 1 0 0 0 0 0 0 0 0 0 0 0
0 0 0 1 1 1 0 0 0 0 0 0 0 0 0 0
0 0 0 1 1 5 0 0 0 0 0 1 1 1 0 0
0 0 0 0 1 1 1 1 0 0 0 1 9 1 0 0
0 0 0 0 0 0 0 1 1 0 0 1 1 1 0 0
0 0 1 1 0 0 0 1 1 0 0 0 0 0 0 0
0 1 1 8 1 1 1 1 1 0 0 0 0 0 0 0
0 1 1 1 0 0 0 1 1 0 0 0 1 1 1 0
0 1 1 1 0 0 0 1 1 5 1 1 1 1 1 0
0 0 0 0 0 0 0 0 0 0 0 0 1 1 1 0