2 10
2 2
3
2 13 2 2 10 2 13
10 6 2 2 4 2 5
10 12 4 2 7 2 8 3 13 4 13
0 0 0 0 0 0 0 0 0 0 0 0 0 0 0 0
0 1 1 1 0 0 0 0 0 1 1 1 1 1 1 0
0 1 9 1 0 0 1 0 0 1 1 1 1 7 1 0
0 1 1 1 0 0 0 0 0 1 1 1 1 0 0 0
0 0 0 0 0 0 0 0 0 0 1 1 1 0 0 0 
0 0 0 0 0 0 0 0 0 0 0 0 1 1 0 0
0 0 0 0 0 0 0 0 0 0 0 0 0 1 0 0
0 0 0 0 0 0 0 0 0 0 0 0 0 1 0 0
0 0 0 0 0 0 0 0 0 0 0 0 1 1 0 0
0 0 0 0 0 1 1 1 1 1 0 0 1 1 0 0
0 0 0 0 0 1 5 0 0 1 1 1 3 1 0 0
0 0 0 0 0 0 0 0 0 0 0 0 0 0 0 0