4 2
8 2
13
3 6 0 2 8 4 8 5 0
1 8 0 2 8 4 8 5 0
5 8 0 2 8 4 8 5 0
8 7 0 2 8 4 8 5 0 
3 9 0 2 8 4 8 5 0 
4 10 0 2 8 4 8 5 0 
4 11 0 2 8 4 8 5 0 
5 11 0 2 8 4 8 5 0  
6 12 0 2 8 4 8 5 0 
7 12 0 2 8 4 8 5 0 
4 14 0 2 8 4 8 5 0 
8 14 0 2 8 4 8 5 0 
8 15 0 0 1 2 12
0 0 0 0 0 0 0 0 0 0 0 0 0 0 0 0 0
0 0 0 0 0 0 1 1 4 1 1 1 0 0 0 0 0
0 0 0 0 0 0 1 1 1 1 1 1 0 0 0 0 0 
0 1 1 1 0 0 4 1 1 4 1 1 1 1 1 0 0
0 1 1 1 1 1 1 1 1 1 4 4 1 1 4 0 0
0 0 0 0 0 0 1 1 4 1 1 4 1 1 1 0 0
0 0 0 0 0 0 1 1 1 1 1 1 4 1 1 0 0
0 1 1 1 0 0 1 1 1 1 1 1 4 1 1 1 0
0 1 6 1 1 1 1 4 1 0 0 1 1 1 4 3 0
0 1 1 1 0 0 1 1 1 0 0 0 1 1 1 1 0
0 1 1 1 0 0 0 0 0 0 0 0 0 1 1 1 0
0 0 0 0 0 0 0 0 0 0 0 0 0 0 0 0 0