2 14
10 2
4
2 9 2 2 6 2 7
4 4 2 9 6 9 7
6 7 2 9 6 9 7
7 15 2 9 6 9 7
0 0 0 0 0 0 0 0 0 0 0 0 0 0 0 0 0
0 0 0 0 0 0 0 0 0 0 0 0 1 1 1 1 0
0 0 1 1 1 1 1 1 1 5 1 1 1 1 1 1 0 
0 0 1 1 1 1 0 0 0 0 0 0 0 1 1 1 0
0 0 1 1 6 1 0 0 0 0 0 0 0 0 0 0 0
0 0 1 1 1 1 0 0 0 0 0 0 0 0 0 0 0
0 0 0 0 1 1 1 4 1 1 1 1 1 1 0 0 0
0 0 0 0 0 0 0 0 0 0 0 1 1 1 1 5 0
0 1 1 1 0 0 0 0 0 0 0 1 1 1 1 1 0
0 1 9 1 1 1 1 1 1 1 1 1 1 1 0 0 0
0 1 1 1 1 0 0 0 0 0 0 0 0 0 0 0 0
0 0 0 0 0 0 0 0 0 0 0 0 0 0 0 0 0