4 2
6 14
2
6 9 1 10 4 0 0
7 9 1 8 6 0 0
0 0 0 0 0 0 0 0 0 0 0 0 0 0 0 0 0
0 0 0 0 0 0 0 0 0 1 1 0 0 0 0 0 0
0 0 0 0 0 0 0 0 1 1 1 0 0 0 0 0 0
0 1 1 0 0 1 1 1 1 1 1 0 0 0 0 0 0
0 1 1 1 1 1 1 0 0 1 0 0 0 0 0 0 0
0 1 1 1 1 0 0 0 0 1 0 0 0 1 1 1 0
0 0 1 1 0 0 0 0 0 3 1 1 1 1 6 1 0
0 0 0 1 0 0 0 0 0 3 1 0 0 1 1 1 0
0 0 0 1 1 1 0 0 0 1 1 0 0 0 0 0 0
0 0 0 0 1 1 1 0 0 1 1 0 0 0 0 0 0
0 0 0 0 0 1 1 1 1 1 1 0 0 0 0 0 0
0 0 0 0 0 0 0 0 0 0 0 0 0 0 0 0 0