1 9
7 2
3
1 11 2 6 8 6 9 0 0
6 11 0 2 10 3 10 4 0
10 11 0 0 2 10 3 10 4
0 0 0 0 0 0 0 0 0 0 0 0 0 0 0 0 0
0 0 1 1 1 1 1 1 1 1 1 4 1 1 1 1 0
0 0 0 0 0 0 1 1 0 0 0 0 0 0 1 1 0 
0 0 0 0 0 0 1 1 0 0 0 0 0 0 1 1 0
0 0 0 0 0 0 0 0 0 0 0 0 0 0 1 1 0
0 0 0 0 0 0 0 0 0 0 0 0 0 0 1 1 0
0 1 1 1 0 0 1 1 0 0 1 4 1 1 1 1 0
0 1 6 1 0 0 1 1 0 0 0 0 0 0 0 0 0
0 1 1 1 0 0 1 1 0 0 0 0 0 0 0 0 0
0 0 1 1 0 0 1 1 0 0 0 0 0 0 0 0 0
0 0 1 1 1 1 1 1 1 1 1 4 1 1 1 0 0
0 0 0 0 0 0 0 0 0 0 0 0 0 0 0 0 0