8 5
4 9
5
2 3 0 0 1 4 5
2 14 1 10 9 0 2 7 2 7 3
4 15 0 3 3 11 3 12 7 15 0
6 1 0 2 7 2 7 3 1 4 1
8 13 2 3 3 8 13
0 0 0 0 0 0 0 0 0 0 0 0 0 0 0 0 0
0 0 1 1 1 0 0 0 0 0 0 0 0 1 1 1 0
0 0 1 3 1 0 0 0 0 0 0 0 0 1 4 1 0
0 0 1 1 1 0 0 0 1 1 1 1 1 1 1 1 0
0 0 1 1 1 0 0 0 1 6 1 0 0 1 1 4 0
0 1 0 0 0 1 0 0 1 1 1 0 0 0 0 1 0
0 4 0 0 0 1 0 0 2 2 2 0 0 0 0 1 0
0 1 0 0 1 1 1 2 2 2 2 2 1 1 1 1 0
0 0 0 0 1 1 1 2 2 2 2 2 1 5 1 0 0
0 0 0 0 1 1 1 2 2 2 2 2 1 1 1 0 0
0 0 0 0 1 1 1 1 1 0 0 0 0 0 0 0 0
0 0 0 0 0 0 0 0 0 0 0 0 0 0 0 0 0