2 14
10 2
4
2 9 2 2 6 2 7 0 0
4 4 0 0 2 9 6 9 7
6 7 0 2 9 6 9 7 0 
7 15 2 9 6 9 7 0 0
0 0 0 0 0 0 0 0 0 0 0 0 0 0 0 0 0
0 0 0 0 0 0 0 0 0 0 0 0 1 1 1 1 0
0 0 1 1 1 1 1 1 1 4 1 1 1 1 1 1 0 
0 0 1 1 1 1 0 0 0 0 0 0 0 1 1 1 0
0 0 1 1 4 1 0 0 0 0 0 0 0 0 0 0 0
0 0 1 1 1 1 0 0 0 0 0 0 0 0 0 0 0
0 0 0 0 1 1 1 4 1 1 1 1 1 1 0 0 0
0 0 0 0 0 0 0 0 0 0 0 1 1 1 1 4 0
0 1 1 1 0 0 0 0 0 0 0 1 1 1 1 1 0
0 1 6 1 1 1 1 1 1 1 1 1 1 1 0 0 0
0 1 1 1 1 0 0 0 0 0 0 0 0 0 0 0 0
0 0 0 0 0 0 0 0 0 0 0 0 0 0 0 0 0