2 2
3 14
5
9 2 1 8 9
7 13 0 0 1 3 8
10 13 0 1 8 9 1 2 10
4 13 0 1 7 7
4 14 0 0 1 7 7
0 0 0 0 0 0 0 0 0 0 0 0 0 0 0 0 0
0 1 1 1 0 0 0 0 0 0 0 0 0 0 0 0 0
0 1 1 1 1 1 1 1 1 1 0 0 0 1 1 1 0
0 1 1 1 0 0 0 0 0 1 1 1 1 1 9 1 0
0 1 1 1 0 0 0 0 0 0 0 0 0 3 3 1 0
0 1 1 1 0 0 0 0 0 0 0 0 0 0 0 0 0
0 1 1 1 0 0 0 0 0 0 0 0 0 0 0 0 0
0 1 1 1 0 0 0 0 1 1 1 1 1 3 0 0 0
0 1 1 1 1 1 1 1 1 0 0 0 1 1 0 0 0
0 1 5 1 0 0 0 0 0 0 0 0 1 1 0 0 0
0 1 1 1 0 0 0 0 0 0 0 0 1 3 0 0 0
0 0 0 0 0 0 0 0 0 0 0 0 0 0 0 0 0